1 1 1 G G G G G G G G G G G G G G G G G G G G G G
2 T 3 1 G G 1 2 3 3 3 3 3 2 1 G G G 1 1 1 1 1 1 G
3 T T 3 2 2 2 T T T T T T T 2 G 1 2 4 T 2 1 T 1 G
3 T T 4 T T 2 2 5 T 5 3 5 T 3 G 2 T T T 2 2 2 2 G
4 T T 5 3 4 2 1 3 T 5 3 5 T 3 G 2 T T 3 1 1 T 1 G
T T T 3 T 2 T 1 2 T T T T T 2 G 1 2 3 2 2 3 3 2 G
T 7 4 3 1 2 2 2 2 2 4 4 4 2 1 1 1 1 1 T 2 T T 1 G
T T T 1 G G 1 T 1 G 1 T 1 G G 1 T 1 1 2 4 5 5 4 2
2 3 2 2 2 3 3 2 2 2 4 3 3 1 1 1 2 2 2 2 T T T T T
G G G 2 T T T 1 2 T T T 4 T 3 2 3 T 3 T 6 T T T T
G G G 3 T 6 4 3 4 T T T 5 T T 3 T T 4 2 T T T 8 T
G G G 3 T 6 T T 4 T 7 4 5 T 5 T 5 T 3 1 3 T T T T
G G G 2 T T T 3 3 T T T 3 T 3 1 3 T 2 G 1 2 3 3 2
G G G 1 2 3 2 1 1 2 3 2 2 1 1 G 1 1 1 G G G G G G
1 2 1 2 1 2 1 2 2 3 2 2 2 3 2 2 2 3 2 2 2 3 2 1 G
T 5 T 4 T 4 T 4 T T T 3 T T T 3 T T T 4 T T T 2 G
T T T 6 T 6 T 6 T 7 T 4 4 T 4 4 T T T 5 T 7 T 2 G
T 7 T 6 T 7 T 6 T 6 T 3 3 T 3 3 T 7 4 5 T T 3 2 G
T 4 T 4 T T T 4 T 4 T 2 2 T 2 2 T T T 3 T 4 T 1 G
2 4 4 5 4 4 2 2 2 3 3 2 2 1 1 1 3 5 5 5 4 4 2 1 G
3 T T T T 3 1 1 3 T 5 T 3 1 G 1 2 T T T T T 2 1 G
T T G G T T 1 1 T T T T T 1 G 1 T 5 T 6 T 5 T 1 G
3 T T T T 3 1 1 3 T T T 4 2 1 1 2 T 4 T 4 T 2 1 G
1 4 T T 4 1 G G 1 3 T 3 2 T 1 G 1 2 T 4 T 2 1 G G
G 2 T T 2 G G G G 1 1 1 1 1 1 G G 1 2 T 2 1 G G G
