G 1 2 2 1 G G G G
G 1 T T 1 1 1 1 G
2 4 5 4 2 2 T 3 1
T T T T 1 2 T T 1
2 3 3 2 1 1 2 2 1
G 1 1 1 1 2 3 3 2
G 2 T 2 1 T T T T
G 3 T 3 1 2 3 3 2
G 2 T 2 G G G G G
