G G G G G G G G G G G G G G G 1 1 1 G G
G G G G G G G G G G G G G G G 2 T 2 G G
G G G G G G G G G G G G G G G 3 T 3 G G
G G G G G G G G G G G G G G G 2 T 2 G G
G G G G G G 1 2 3 2 1 G G G G 1 1 1 G G
G G G G G G 1 T T T 1 G G G G G G G G G
G G G G G G 1 2 3 2 1 G G G G G G G G G
G G G G G G G G 1 1 1 G G G G G G G G G
G G G G G G G G 2 T 2 G G G G G G G G G
G G G G G G G G 3 T 3 G G G G G G G G G
G G 1 1 1 G G G 2 T 2 G G G G G G G G G
G G 2 T 2 G G G 1 1 1 G G G T G G G G G
G G 2 T 2 G G G G G G G 1 2 3 2 1 G G G
G G 1 1 1 G G G G G G G 1 T G T 1 G G G
G G G G G G G G T G G G 1 2 3 2 1 G G G
G G G G G G 1 2 3 2 1 G G G T G G G G G
G G G G G G 1 T G T 1 G G G G G G G G G
G G G G G G 1 2 3 2 1 G G G G G G G G G
G G G G G G G G T G G G G G G G G G G G
G G G G G G G G G G G G G G G G G G G G
