G G G G G G G G 2 T T
G G G G G G G G 3 T 5
G T T T G G G G 3 T T
2 3 3 2 1 T G T 3 T 5
T G G G 2 1 1 1 2 G T
T T 6 T 5 4 T 2 1 2 2
2 2 3 G G T G 2 1 1 1
G G 2 3 4 3 2 1 1 G 1
G T 2 T 2 T G G 1 1 1
G G 3 G 4 1 1 1 1 1 G
G T 2 G 3 T 1 1 T 1 T
