10 10
1,_,1,1,_,_,3,_,1,_
2,2,1,2,3,4,_,3,2,1
_,2,1,2,_,3,3,5,_,3
1,2,_,3,3,5,_,_,_,_
1,3,2,3,_,_,_,_,_,_
_,3,_,3,5,_,_,_,5,3
_,3,1,3,_,_,6,4,_,2
2,2,2,3,_,_,4,_,6,_
1,_,3,_,5,3,4,_,_,_
1,1,3,_,3,_,2,2,3,2
