5 10
_,3,_,2,_,2,3,_,3,_
_,4,3,4,3,_,4,_,4,2
2,3,_,_,3,3,_,4,_,1
2,_,4,4,_,3,3,_,3,2
_,3,_,2,1,2,_,2,2,_
