5 5
1,2,3,2,1
1,_,_,_,1
1,2,4,3,2
_,_,2,_,2
_,_,2,_,2
