11 11
_,_,_,_,_,_,_,_,2,_,_
_,_,_,_,_,_,_,_,3,_,5
_,_,_,_,_,_,_,_,3,_,_
2,3,3,2,1,_,_,_,3,_,5
_,_,_,_,2,1,1,1,2,_,_
_,_,6,_,5,4,_,2,1,2,2
2,2,3,_,_,_,_,2,1,1,1
_,_,2,3,4,3,2,1,1,_,1
_,_,2,_,2,_,_,_,1,1,1
_,_,3,_,4,1,1,1,1,1,_
_,_,2,_,3,_,1,1,_,1,_