8 8
_,_,_,_,_,_,_,_
_,1,2,3,3,2,1,_
_,1,_,_,_,_,1,_
_,1,2,3,3,2,1,_
_,_,_,_,_,_,_,_
_,_,_,_,_,_,_,_
_,_,_,_,_,_,_,_
_,_,_,_,_,_,_,_
