8 8
_,_,_,_,_,_,_,_
_,_,_,_,_,_,_,_
_,_,1,2,2,1,_,_
_,_,2,_,_,2,_,_
_,_,2,_,_,2,_,_
_,_,1,2,2,1,_,_
_,_,_,_,_,_,_,_
_,_,_,_,_,_,_,_
